XXXXXXXXXXXXXXXXXXX
X    XX  X       XX
X XX XXX X XXX XX X
X                 X
X XX XXX XXX XX XXX
X    X       X    X
XX X XX X XXXXX   X
OO   X       X  O O
XXXX X XXrXX X XX X
O       bpo       O
X XX X XXXXX X XXXX
O    X   X   X XOOO
XXXX X XXXXX X XXXX
X        X        X
X XX XXX X XXX XX X
X  X     P     X  X
XX X X XXXXX X X XX
X        X   X    X
XX X XXX X X XXX XX
X     X    X      X
XXXXXXXXXXXXXXXXXXX